010101010101010101010
101010101010101010101
010101010101010101010
101010101010101010101
010101010101010101010
101010101010101010101
010101010101010101010
101010100010101010101
010101001001010101010
101010100010101010101
010101010101010101010
101010101010101010101
010101010101010101010
101010101010101010101
010101010101010101010
101010101010101010101
010101010101010101010
101010101010101010101
010101010101010101010