101010101010101010101010101010101010101010101010100303030303030303030303030303030303030303030303034
010101010101010101010101010101010101010101010101013030303030303030303030303030303030303030303030304
101010101010101010101010101010101010101010101010100303030303030303030303030303030303030303030303034
010101010101010101010101010101010101010101010101013030303030303030303030303030303030303030303030304
101010101010101010101010101010101010101010101010100303030303030303030303030303030303030303030303034
010101010101010101010101010101010101010101010101013030303030303030303030303030303030303030303030304
101010101010101010101010101010101010101010101010100303030303030303030303030303030303030303030303034
010101010101010101010101010101010101010101010101013030303030303030303030303030303030303030303030304
101010101010101010101010101010101010101010101010100303030303030303030303030303030303030303030303034
010101010101010101010101010101010101010101010101013030303030303030303030303030303030303030303030304
101010101010101010101010101010101010101010101010100303030303030303030303030303030303030303030303034
010101010101010101010101010101010101010101010101013030303030303030303030303030303030303030303030304
101010101010101010101010101010101010101010101010100303030303030303030303030303030303030303030303034
010101010101010101010101010101010101010101010101013030303030303030303030303030303030303030303030304
101010101010101010101010101010101010101010101010100303030303030303030303030303030303030303030303034
010101010101010101010101010101010101010101010101013030303030303030303030303030303030303030303030304
101010101010101010101010101010101010101010101010100303030303030303030303030303030303030303030303034
010101010101010101010101010101010101010101010101013030303030303030303030303030303030303030303030304
101010101010101010101010101010101010101010101010100303030303030303030303030303030303030303030303034
010101010101010101010101010101010101010101010101013030303030303030303030303030303030303030303030304
101010101010101010101010101010101010101010101010100303030303030303030303030303030303030303030303034
010101010101010101010101010101010101010101010101013030303030303030303030303030303030303030303030304
101010101010101010101010101010101010101010101010100303030303030303030303030303030303030303030303034
010101010101010101010101010101010101010101010101013030303030303030303030303030303030303030303030304
101010101010101010101010101010101010101010101010100303030303030303030303030303030303030303030303034
010101010101010101010101010101010101010101010101013030303030303030303030303030303030303030303030304
101010101010101010101010101010101010101010101010100303030303030303030303030303030303030303030303034
010101010101010101010101010101010101010101010101013030303030303030303030303030303030303030303030304
101010101010101010101010101010101010101010101010100303030303030303030303030303030303030303030303034
010101010101010101010101010101010101010101010101013030303030303030303030303030303030303030303030304
101010101010101010101010101010101010101010101010100303030303030303030303030303030303030303030303034
010101010101010101010101010101010101010101010101013030303030303030303030303030303030303030303030304
101010101010101010101010101010101010101010101010100303030303030303030303030303030303030303030303034
010101010101010101010101010101010101010101010101013030303030303030303030303030303030303030303030304
101010101010101010101010101010101010101010101010100303030303030303030303030303030303030303030303034
010101010101010101010101010101010101010101010101013030303030303030303030303030303030303030303030304
101010101010101010101010101010101010101010101010100303030303030303030303030303030303030303030303034
010101010101010101010101010101010101010101010101013030303030303030303030303030303030303030303030304
101010101010101010101010101010101010101010101010100303030303030303030303030303030303030303030303034
010101010101010101010101010101010101010101010101013030303030303030303030303030303030303030303030304
101010101010101010101010101010101010101010101010100303030303030303030303030303030303030303030303034
010101010101010101010101010101010101010101010101013030303030303030303030303030303030303030303030304
101010101010101010101010101010101010101010101010100303030303030303030303030303030303030303030303034
010101010101010101010101010101010101010101010101013030303030303030303030303030303030303030303030304
101010101010101010101010101010101010101010101010100303030303030303030303030303030303030303030303034
010101010101010101010101010101010101010101010101013030303030303030303030303030303030303030303030304
202020202020202020202020202020202020202020202020200404040404040404040404040404040404040404040404044
020202020202020202020202020202020202020202020202024040404040404040404040404040404040404040404040404
202020202020202020202020202020202020202020202020200404040404040404040404040404040404040404040404044
020202020202020202020202020202020202020202020202024040404040404040404040404040404040404040404040404
202020202020202020202020202020202020202020202020200404040404040404040404040404040404040404040404044
020202020202020202020202020202020202020202020202024040404040404040404040404040404040404040404040404
202020202020202020202020202020202020202020202020200404040404040404040404040404040404040404040404044
020202020202020202020202020202020202020202020202024040404040404040404040404040404040404040404040404
202020202020202020202020202020202020202020202020200404040404040404040404040404040404040404040404044
020202020202020202020202020202020202020202020202024040404040404040404040404040404040404040404040404
202020202020202020202020202020202020202020202020200404040404040404040404040404040404040404040404044
020202020202020202020202020202020202020202020202024040404040404040404040404040404040404040404040404
202020202020202020202020202020202020202020202020200404040404040404040404040404040404040404040404044
020202020202020202020202020202020202020202020202024040404040404040404040404040404040404040404040404
202020202020202020202020202020202020202020202020200404040404040404040404040404040404040404040404044
020202020202020202020202020202020202020202020202024040404040404040404040404040404040404040404040404
202020202020202020202020202020202020202020202020200404040404040404040404040404040404040404040404044
020202020202020202020202020202020202020202020202024040404040404040404040404040404040404040404040404
202020202020202020202020202020202020202020202020200404040404040404040404040404040404040404040404044
020202020202020202020202020202020202020202020202024040404040404040404040404040404040404040404040404
202020202020202020202020202020202020202020202020200404040404040404040404040404040404040404040404044
020202020202020202020202020202020202020202020202024040404040404040404040404040404040404040404040404
202020202020202020202020202020202020202020202020200404040404040404040404040404040404040404040404044
020202020202020202020202020202020202020202020202024040404040404040404040404040404040404040404040404
202020202020202020202020202020202020202020202020200404040404040404040404040404040404040404040404044
020202020202020202020202020202020202020202020202024040404040404040404040404040404040404040404040404
202020202020202020202020202020202020202020202020200404040404040404040404040404040404040404040404044
020202020202020202020202020202020202020202020202024040404040404040404040404040404040404040404040404
202020202020202020202020202020202020202020202020200404040404040404040404040404040404040404040404044
020202020202020202020202020202020202020202020202024040404040404040404040404040404040404040404040404
202020202020202020202020202020202020202020202020200404040404040404040404040404040404040404040404044
020202020202020202020202020202020202020202020202024040404040404040404040404040404040404040404040404
202020202020202020202020202020202020202020202020200404040404040404040404040404040404040404040404044
020202020202020202020202020202020202020202020202024040404040404040404040404040404040404040404040404
202020202020202020202020202020202020202020202020200404040404040404040404040404040404040404040404044
020202020202020202020202020202020202020202020202024040404040404040404040404040404040404040404040404
202020202020202020202020202020202020202020202020200404040404040404040404040404040404040404040404044
020202020202020202020202020202020202020202020202024040404040404040404040404040404040404040404040404
202020202020202020202020202020202020202020202020200404040404040404040404040404040404040404040404044
020202020202020202020202020202020202020202020202024040404040404040404040404040404040404040404040404
202020202020202020202020202020202020202020202020200404040404040404040404040404040404040404040404044
020202020202020202020202020202020202020202020202024040404040404040404040404040404040404040404040404
202020202020202020202020202020202020202020202020200404040404040404040404040404040404040404040404044
020202020202020202020202020202020202020202020202024040404040404040404040404040404040404040404040404
202020202020202020202020202020202020202020202020200404040404040404040404040404040404040404040404044
020202020202020202020202020202020202020202020202024040404040404040404040404040404040404040404040404
202020202020202020202020202020202020202020202020200404040404040404040404040404040404040404040404044
020202020202020202020202020202020202020202020202024040404040404040404040404040404040404040404040404
202020202020202020202020202020202020202020202020200404040404040404040404040404040404040404040404044
020202020202020202020202020202020202020202020202024040404040404040404040404040404040404040404040404
202020202020202020202020202020202020202020202020200404040404040404040404040404040404040404040404044
020202020202020202020202020202020202020202020202024040404040404040404040404040404040404040404040404
444444444444444444444444444444444444444444444444444444444444444444444444444444444444444444444444444



