11111111111111111111100000000000000000000000000000
11111111111111111111100000000000000000000000000000
11111111111111111111000000000000000000000000000000
11111111111111111111000000000000000000000000000000
11111111111111111111000000000000000000000000000000
11111111111111111111000000000000000000000000000000
11111111111111111111000000000000000000000000000000
11111111111111111111000000000000000000000000000000
11111111111111111111000000000000000000000000000000
11111111111111111111000000000000000000000000000000
11111111111111111111110000000000000000000000000000
11111111111111111111110000000000000000000000000000
11111111111111111111111000000000000000000000000000
11111111111111111111111000000000000000000000000000
11111111111111111111111000000000000000000000000000
10111111111111111111111000000000000000000000000000
10111111111111111111110000000000000000000000000000
10111111111111111111111000000000000000000000000000
11111111111111111111111000000000000000000000000000
00111111111111111111111000000000000000000000000000
00111111111111111111111000000000000000000000000000
00111111111111111111110000000000000000000000000000
00111111111111111111110000000000000000000000000000
00111111111111111111110000000000000000000000000000
00111111111111111111110000000000000000000000000000
00110000011110000000000000000000000000000000000000
00000000000000000000000000000000000000000000000000
00000000000000000000000000000000000000000000000000
00000000000000000000000000000000000000000000000000
00000000000000000000000000000000000000000000000000
00000000000000000000000000000000000000000000000000
00000000000000000000000000000000000000000000000000
00000000000000000000000000000000000000000000000000
00000000000000000000000000000000000000000000000000
00000000000000000000000000000000000000000000000000
00000000000000000000000000000000000000000000000000
00000000000000000000000000000000000000000000000000
00000000000000000000000000000000000000000000000000
00000000000000000000000000000000000000000000000000
00000000000000000000000000000000000000000000000000
00000000000000000000000000000000000000000000000000
00000000000000000000000000000000000000000000000000
00000000000000000000000000000000000000000000000000
00000000000000000000000000000000000000000000000000
00000000000000000000000000000000000000000000000000
00000000000000000000000000000000000000000000000000
00000000000000000000000000000000000000000000000000
00000000000000000000000000000000000000000000000000
00000000000000000000000000000000000000000000000000
00000000000000000000000000000000000000000000000000
